XXXXXXXXXX
X........X
X.X.X.XX.X
X.X..P...X
X.XXXXXX.X
X...O....X
X.X.XX.X.X
X.X....X.X
X.XX.XXX.X
X........X
XXXXXXXXXX